c(anomalize = "anomalize", apcluster = "apcluster", arrow = "arrow", 
BiocGenerics = "BiocGenerics", BiocManager = "BiocManager", BiocVersion = "BiocVersion", 
Biostrings = "Biostrings", bitops = "bitops", caret = "caret", 
classInt = "classInt", colourpicker = "colourpicker", commonmark = "commonmark", 
crsmeta = "crsmeta", curl = "curl", datawizard = "datawizard", 
devEMF = "devEMF", dichromat = "dichromat", distributional = "distributional", 
dotCall64 = "dotCall64", dygraphs = "dygraphs", e1071 = "e1071", 
editData = "editData", extraDistr = "extraDistr", fields = "fields", 
flextable = "flextable", FNN = "FNN", fontBitstreamVera = "fontBitstreamVera", 
fontLiberation = "fontLiberation", fontquiver = "fontquiver", 
future = "future", future.callr = "future.callr", gdtools = "gdtools", 
GenomeInfoDb = "GenomeInfoDb", GenomeInfoDbData = "GenomeInfoDbData", 
gfonts = "gfonts", ggExtra = "ggExtra", ggforce = "ggforce", 
ggmap = "ggmap", ggstream = "ggstream", glmnet = "glmnet", gstat = "gstat", 
httr2 = "httr2", inline = "inline", insight = "insight", intervals = "intervals", 
IRanges = "IRanges", IRdisplay = "IRdisplay", IRkernel = "IRkernel", 
jpeg = "jpeg", jsonlite = "jsonlite", kebabs = "kebabs", keras = "keras", 
kernlab = "kernlab", leaflet = "leaflet", leaflet.providers = "leaflet.providers", 
LiblineaR = "LiblineaR", lightgbm = "lightgbm", locfit = "locfit", 
loo = "loo", lsa = "lsa", lwgeom = "lwgeom", mapdata = "mapdata", 
maps = "maps", markdown = "markdown", mnormt = "mnormt", ModelMetrics = "ModelMetrics", 
mongolite = "mongolite", moonBook = "moonBook", nortest = "nortest", 
officer = "officer", osmdata = "osmdata", pbdZMQ = "pbdZMQ", 
plotrix = "plotrix", posterior = "posterior", pROC = "pROC", 
PROJ = "PROJ", proj4 = "proj4", prophet = "prophet", proxy = "proxy", 
psych = "psych", QuickJSR = "QuickJSR", randomForest = "randomForest", 
raster = "raster", RcppEigen = "RcppEigen", RcppParallel = "RcppParallel", 
RCurl = "RCurl", reactlog = "reactlog", remotes = "remotes", 
repr = "repr", reproj = "reproj", reticulate = "reticulate", 
RgoogleMaps = "RgoogleMaps", rio = "rio", RJSONIO = "RJSONIO", 
rlang = "rlang", RMariaDB = "RMariaDB", rrtable = "rrtable", 
rstan = "rstan", rstantools = "rstantools", rts = "rts", rvg = "rvg", 
s2 = "s2", S4Vectors = "S4Vectors", sf = "sf", sftime = "sftime", 
shape = "shape", shinyFeedback = "shinyFeedback", shinyjs = "shinyjs", 
ShinyTester = "ShinyTester", shinyvalidate = "shinyvalidate", 
sjlabelled = "sjlabelled", sjmisc = "sjmisc", SnowballC = "SnowballC", 
spacetime = "spacetime", spam = "spam", spatialEco = "spatialEco", 
spatstat.core = "spatstat.core", spatsurv = "spatsurv", StanHeaders = "StanHeaders", 
stars = "stars", STRbook = "STRbook", stringdist = "stringdist", 
sweep = "sweep", tensorA = "tensorA", tensorflow = "tensorflow", 
terra = "terra", tfautograph = "tfautograph", tfruns = "tfruns", 
tibbletime = "tibbletime", tmaptools = "tmaptools", TSA = "TSA", 
units = "units", vcd = "vcd", vctrs = "vctrs", visNetwork = "visNetwork", 
webr = "webr", wk = "wk", writexl = "writexl", xfun = "xfun", 
xgboost = "xgboost", XVector = "XVector", zeallot = "zeallot", 
zlibbioc = "zlibbioc", ztable = "ztable", abind = "abind", alphavantager = "alphavantager", 
anytime = "anytime", askpass = "askpass", assertthat = "assertthat", 
attachment = "attachment", attempt = "attempt", backports = "backports", 
base = "base", base64enc = "base64enc", BH = "BH", billboarder = "billboarder", 
bit = "bit", bit64 = "bit64", blob = "blob", Boom = "Boom", BoomSpikeSlab = "BoomSpikeSlab", 
boot = "boot", brew = "brew", brio = "brio", broom = "broom", 
bslib = "bslib", bsts = "bsts", cachem = "cachem", callr = "callr", 
car = "car", carData = "carData", cellranger = "cellranger", 
checkmate = "checkmate", class = "class", cli = "cli", clipr = "clipr", 
clock = "clock", cluster = "cluster", codetools = "codetools", 
colorspace = "colorspace", commonmark = "commonmark", compiler = "compiler", 
config = "config", ConvCalendar = "ConvCalendar", corrplot = "corrplot", 
cowplot = "cowplot", cpp11 = "cpp11", crayon = "crayon", credentials = "credentials", 
crosstalk = "crosstalk", crul = "crul", curl = "curl", data.table = "data.table", 
datasets = "datasets", DBI = "DBI", dbplyr = "dbplyr", deldir = "deldir", 
dendextend = "dendextend", desc = "desc", devtools = "devtools", 
diffobj = "diffobj", digest = "digest", doParallel = "doParallel", 
downlit = "downlit", dplyr = "dplyr", DT = "DT", dtplyr = "dtplyr", 
ellipse = "ellipse", ellipsis = "ellipsis", emmeans = "emmeans", 
estimability = "estimability", evaluate = "evaluate", extrafont = "extrafont", 
extrafontdb = "extrafontdb", factoextra = "factoextra", FactoMineR = "FactoMineR", 
fansi = "fansi", farver = "farver", fastmap = "fastmap", flashClust = "flashClust", 
flexdashboard = "flexdashboard", fontawesome = "fontawesome", 
forcats = "forcats", foreach = "foreach", forecast = "forecast", 
foreign = "foreign", forge = "forge", formattable = "formattable", 
fracdiff = "fracdiff", fresh = "fresh", fs = "fs", furrr = "furrr", 
future = "future", future.apply = "future.apply", gapminder = "gapminder", 
gargle = "gargle", generics = "generics", gert = "gert", GGally = "GGally", 
gganimate = "gganimate", ggplot2 = "ggplot2", ggpubr = "ggpubr", 
ggrepel = "ggrepel", ggsci = "ggsci", ggsignif = "ggsignif", 
gh = "gh", gitcreds = "gitcreds", globals = "globals", glue = "glue", 
goftest = "goftest", golem = "golem", googledrive = "googledrive", 
googlesheets4 = "googlesheets4", gower = "gower", graphics = "graphics", 
grDevices = "grDevices", grid = "grid", gridExtra = "gridExtra", 
gtable = "gtable", hardhat = "hardhat", haven = "haven", here = "here", 
highcharter = "highcharter", highr = "highr", hms = "hms", htmltools = "htmltools", 
htmlwidgets = "htmlwidgets", httpcode = "httpcode", httpuv = "httpuv", 
httr = "httr", ids = "ids", igraph = "igraph", ini = "ini", ipred = "ipred", 
ISLR2 = "ISLR2", isoband = "isoband", iterators = "iterators", 
jalcal = "jalcal", janitor = "janitor", jqr = "jqr", jquerylib = "jquerylib", 
jsonlite = "jsonlite", kableExtra = "kableExtra", KernSmooth = "KernSmooth", 
knitr = "knitr", labeling = "labeling", later = "later", lattice = "lattice", 
lava = "lava", lazyeval = "lazyeval", leaps = "leaps", lifecycle = "lifecycle", 
listenv = "listenv", lme4 = "lme4", lmtest = "lmtest", lobstr = "lobstr", 
lubridate = "lubridate", magick = "magick", magrittr = "magrittr", 
maptools = "maptools", MASS = "MASS", Matrix = "Matrix", MatrixModels = "MatrixModels", 
matrixStats = "matrixStats", memoise = "memoise", methods = "methods", 
mgcv = "mgcv", mime = "mime", miniUI = "miniUI", minqa = "minqa", 
misc3d = "misc3d", modelr = "modelr", multcompView = "multcompView", 
munsell = "munsell", mvtnorm = "mvtnorm", nlme = "nlme", nloptr = "nloptr", 
nnet = "nnet", numDeriv = "numDeriv", odbc = "odbc", openssl = "openssl", 
openxlsx = "openxlsx", pacman = "pacman", padr = "padr", pander = "pander", 
parallel = "parallel", parallelly = "parallelly", pbkrtest = "pbkrtest", 
PerformanceAnalytics = "PerformanceAnalytics", pillar = "pillar", 
pkgbuild = "pkgbuild", pkgconfig = "pkgconfig", pkgdown = "pkgdown", 
pkgload = "pkgload", plogr = "plogr", plotly = "plotly", plumber = "plumber", 
plyr = "plyr", png = "png", polyclip = "polyclip", polynom = "polynom", 
pool = "pool", praise = "praise", prettyunits = "prettyunits", 
processx = "processx", prodlim = "prodlim", profvis = "profvis", 
progress = "progress", progressr = "progressr", promises = "promises", 
pryr = "pryr", ps = "ps", purrr = "purrr", quadprog = "quadprog", 
Quandl = "Quandl", quantmod = "quantmod", quantreg = "quantreg", 
R.cache = "R.cache", R.methodsS3 = "R.methodsS3", R.oo = "R.oo", 
R.utils = "R.utils", r2d3 = "r2d3", R6 = "R6", ragg = "ragg", 
rappdirs = "rappdirs", rapportools = "rapportools", rcmdcheck = "rcmdcheck", 
RColorBrewer = "RColorBrewer", Rcpp = "Rcpp", RcppArmadillo = "RcppArmadillo", 
RcppEigen = "RcppEigen", RcppRoll = "RcppRoll", RcppTOML = "RcppTOML", 
reactable = "reactable", reactR = "reactR", readr = "readr", 
readxl = "readxl", recipes = "recipes", rematch = "rematch", 
rematch2 = "rematch2", remotes = "remotes", reprex = "reprex", 
reshape = "reshape", reshape2 = "reshape2", reticulate = "reticulate", 
rhandsontable = "rhandsontable", riingo = "riingo", rJava = "rJava", 
RJDBC = "RJDBC", rjson = "rjson", rlang = "rlang", rlist = "rlist", 
rmarkdown = "rmarkdown", roxygen2 = "roxygen2", rpart = "rpart", 
RPostgres = "RPostgres", rprojroot = "rprojroot", rsample = "rsample", 
RSQLite = "RSQLite", rstatix = "rstatix", rstudioapi = "rstudioapi", 
Rttf2pt1 = "Rttf2pt1", rversions = "rversions", rvest = "rvest", 
sass = "sass", scales = "scales", scatterplot3d = "scatterplot3d", 
scrypt = "scrypt", selectr = "selectr", sessioninfo = "sessioninfo", 
shiny = "shiny", shinybusy = "shinybusy", shinycssloaders = "shinycssloaders", 
shinydashboard = "shinydashboard", shinydashboardPlus = "shinydashboardPlus", 
shinyfullscreen = "shinyfullscreen", shinymanager = "shinymanager", 
shinythemes = "shinythemes", shinyWidgets = "shinyWidgets", showtext = "showtext", 
showtextdb = "showtextdb", slider = "slider", snakecase = "snakecase", 
sodium = "sodium", sourcetools = "sourcetools", sp = "sp", sparklyr = "sparklyr", 
sparr = "sparr", SparseM = "SparseM", spatial = "spatial", spatstat = "spatstat", 
spatstat.data = "spatstat.data", spatstat.explore = "spatstat.explore", 
spatstat.geom = "spatstat.geom", spatstat.linnet = "spatstat.linnet", 
spatstat.model = "spatstat.model", spatstat.random = "spatstat.random", 
spatstat.sparse = "spatstat.sparse", spatstat.utils = "spatstat.utils", 
splines = "splines", SQUAREM = "SQUAREM", stats = "stats", stats4 = "stats4", 
stringi = "stringi", stringr = "stringr", styler = "styler", 
summarytools = "summarytools", survival = "survival", svglite = "svglite", 
swagger = "swagger", sys = "sys", sysfonts = "sysfonts", systemfonts = "systemfonts", 
tcltk = "tcltk", tensor = "tensor", testthat = "testthat", textshaping = "textshaping", 
thematic = "thematic", tibble = "tibble", tidyquant = "tidyquant", 
tidyr = "tidyr", tidyselect = "tidyselect", tidyverse = "tidyverse", 
timechange = "timechange", timeDate = "timeDate", timetk = "timetk", 
tinytex = "tinytex", tools = "tools", translations = "translations", 
triebeard = "triebeard", tseries = "tseries", tsfeatures = "tsfeatures", 
TTR = "TTR", tweenr = "tweenr", tzdb = "tzdb", urca = "urca", 
urlchecker = "urlchecker", urltools = "urltools", usethis = "usethis", 
utf8 = "utf8", utils = "utils", uuid = "uuid", vctrs = "vctrs", 
viridis = "viridis", viridisLite = "viridisLite", vroom = "vroom", 
waiter = "waiter", waldo = "waldo", warp = "warp", webshot = "webshot", 
webutils = "webutils", whisker = "whisker", withr = "withr", 
xfun = "xfun", XML = "XML", xml2 = "xml2", xopen = "xopen", xtable = "xtable", 
xts = "xts", yaml = "yaml", zgtools = "zgtools", zip = "zip", 
zoo = "zoo")
